[
    [
        {
            "visibleBox": {
                "height": 0.48,
                "cutLeft": 0.31,
                "cutRight": 0.29
            },
            "map": [
                "00000000000000000000000000000000000000000000000000000000000000000000000000000000",
                "00000000000000000000000000000000000000000000000000000000000000000000000000000000",
                "00000000000000000000000000000000000000000000000000000000000000000000000000000000",
                "00000000000000000000000000000000000000000000000000000000000000000000000000000000",
                "00000000000000000000000000000000000000000000000000000000000000000000000000000000",
                "00000000000000000000000000000000000000000000000000000000000000000000000000000000",
                "00000000000000000000000000000000000000000000000000000000000000000000000000000000",
                "00000000000000000000000000000000000000000000000000000000000000000000000000000000",
                "00000000000000000000000000000000000000000000000000000000000000000000000000000000",
                "00000000000000000000000000000000000000000000000000000000000000000000000000000000",
                "00000000000000000000000000000000000000000000000000000000000000000000000000000000",
                "00000000000000000000000000000000000000000000000000000000000000000000000000000000",
                "00000000000000000000000000000000000000000000000000000000000000000000000000000000",
                "00000000000000000000000000000000000000000000000000000000000000000000000000000000",
                "00000000000000000000000000000000000000000000000000000000000000000000000000000000",
                "00000000000000000000000000000000000000000000000000000000000000000000000000000000",
                "00000000000000000000000000000000000000000000000000000000000000000000000000000000",
                "00000000000000000000000000000000000000000000000000000000000000000000000000000000",
                "00000000000000000000000000000000000000000000000000000000000000000000000000000000",
                "00000000000000000000000000000000000000000000000000000000000000000000000000000000",
                "00000000000000000000000000000000000000000000000000000000000000000000000000000000",
                "00000000000000000000000000000000000000000000000000000000000000000000000000000000",
                "00000000000000000000000000000000000000000000000000000000000000000000000000000000",
                "00000000000000000000000000000000000000000000000000000000000000000000000000000000",
                "00000000000000000000000000000000000000000000000000000000000000000000000000000000",
                "00000000000000000000000000000000000000000000000000000000000000000000000000000000",
                "00000000000000000000000000000000000000000000000000000000000000000000000000000000",
                "00000000000000000000000000000000000000000000000000000000000000000000000000000000",
                "00000000000000000000000000000000000000000000000000000000000000000000000000000000",
                "00000000000000000000000000000000000000000000000000000000000000000000000000000000",
                "00000000000000000000000000000000000000000000000000000000000000000000000000000000",
                "00000000000000000000000000000000000000000000000000000000000000000000000000000000",
                "00000000000000000000000000000000000000000000000000000000000000000000000000000000",
                "00000000000000000000000000000000000000000000000000000000000000000000000000000000",
                "00000000000000000000000000000000000000000000000000000000000000000000000000000000",
                "00000000000000000000000000000000000000000000000000000000000000000000000000000000",
                "00000000000000000000000000000000000000000000000000000000000000000000000000000000",
                "00000000000000000000000000000000000000000000000000000000000000000000000000000000",
                "00000000000000000000000000000000000000000000000000000000000000000000000000000000",
                "00000000000000000000000000000000000000000000000000000000000000000000000000000000",
                "00000000000000000000000000000000000000000000000000000000000000000000000000000000",
                "00000000000000000000000000000000000000000000000000000000000000000000000000000000",
                "00000000000000000000000000000000000000001100000000000000000000000000000000000000",
                "00000000000000000000000000000000000000001100000000000000000000000000000000000000",
                "00000000000000000000000000000000000000000000000000000000000000000000000000000000",
                "00000000000000000000000000000000000000000000000000000000000000000000000000000000",
                "00000000000000000000000000000000000000000000000000000000000000000000000000000000",
                "00000000000000000000000000000000000000000000000000000000000000000000000000000000",
                "00000000000000000000000000000000000000000000000000000000000000000000000000000000",
                "00000000000000000000000000000000000000000000000000000000000000000000000000000000",
                "00000000000000000000000000000000000000000000000000000000000000000000000000000000",
                "00000000000000000000000000000000000000000000000000000000000000000000000000000000",
                "00000000000000000000000000000000000000000000000000000000000000000000000000000000",
                "00000000000000000000000000000000000000000000000000000000000000000000000000000000",
                "00000000000000000000000000000000000000000000000000000000000000000000000000000000",
                "00000000000000000000000000000000000000000000000000000000000000000000000000000000",
                "00000000000000000000000000000000000000000000000000000000000000000000000000000000",
                "00000000000000000000000000000000000000000000000000000000000000000000000000000000",
                "00000000000000000000000000000000000000000000000000000000000000000000000000000000",
                "00000000000000000000000000000000000000000000000000000000000000000000000000000000",
                "00000000000000000000000000000000000000000000000000000000000000000000000000000000",
                "00000000000000000000000000000000000000000000000000000000000000000000000000000000",
                "00000000000000000000000000000000000000000000000000000000000000000000000000000000",
                "00000000000000000000000000000000000000000000000000000000000000000000000000000000",
                "00000000000000000000000000000000000000000000000000000000000000000000000000000000",
                "00000000000000000000000000000000000000000000000000000000000000000000000000000000",
                "00000000000000000000000000000000000000000000000000000000000000000000000000000000",
                "00000000000000000000000000000000000000000000000000000000000000000000000000000000",
                "00000000000000000000000000000000000000000000000000000000000000000000000000000000",
                "00000000000000000000000000000000000000000000000000000000000000000000000000000000",
                "00000000000000000000000000000000000000000000000000000000000000000000000000000000",
                "00000000000000000000000000000000000000000000000000000000000000000000000000000000",
                "00000000000000000000000000000000000000000000000000000000000000000000000000000000",
                "00000000000000000000000000000000000000000000000000000000000000000000000000000000",
                "00000000000000000000000000000000000000000000000000000000000000000000000000000000",
                "00000000000000000000000000000000000000000000000000000000000000000000000000000000",
                "00000000000000000000000000000000000000000000000000000000000000000000000000000000",
                "00000000000000000000000000000000000000000000000000000000000000000000000000000000",
                "00000000000000000000000000000000000000000000000000000000000000000000000000000000",
                "00000000000000000000000000000000000000000000000000000000000000000000000000000000"
            ],
            "terrains": [
                "................................................................................",
                "................................................................................",
                "................................................................................",
                "................................................................................",
                "................................................................................",
                "................................................................................",
                "................................................................................",
                "................................................................................",
                "................................................................................",
                "................................................................................",
                "................................................................................",
                "................................................................................",
                "................................................................................",
                "................................................................................",
                "................................................................................",
                "................................................................................",
                "................................................................................",
                "................................................................................",
                "................................................................................",
                "................................................................................",
                "................................................................................",
                "................................................................................",
                "................................................................................",
                "................................................................................",
                "................................................................................",
                "................................................................................",
                "................................................................................",
                "................................................................................",
                "................................................................................",
                "................................................................................",
                "................................................................................",
                "................................................................................",
                "................................................................................",
                "................................................................................",
                "................................................................................",
                "................................................................................",
                "................................................................................",
                "................................................................................",
                "................................................................................",
                "................................................................................",
                "................................................................................",
                "................................................................................",
                "........................................bb......................................",
                "........................................bb......................................",
                "................................................................................",
                "................................................................................",
                "................................................................................",
                "................................................................................",
                "................................................................................",
                "................................................................................",
                "................................................................................",
                "................................................................................",
                "................................................................................",
                "................................................................................",
                "................................................................................",
                "................................................................................",
                "................................................................................",
                "................................................................................",
                "................................................................................",
                "................................................................................",
                "................................................................................",
                "................................................................................",
                "................................................................................",
                "................................................................................",
                "................................................................................",
                "................................................................................",
                "................................................................................",
                "................................................................................",
                "................................................................................",
                "................................................................................",
                "................................................................................",
                "................................................................................",
                "................................................................................",
                "................................................................................",
                "................................................................................",
                "................................................................................",
                "................................................................................",
                "................................................................................",
                "................................................................................",
                "................................................................................"
            ],
            "field": [],
            "episodeNo": "sand",
            "levelNo": 0,
            "version": 0,
            "regions": {},
            "decorators": []
        }
    ]
]