[
    [
        {
            "visibleBox": {
                "height": 0.48,
                "cutLeft": 0.31,
                "cutRight": 0.29
            },
            "map": [
                "00000000000000000000000000000000000000000000000000000000000000000000000000000000",
                "00000000000000000000000000000000000000000000000000000000000000000000000000000000",
                "00000000000000000000000000000000000000000000000000000000000000000000000000000000",
                "00000000000000000000000000000000000000000000000000000000000000000000000000000000",
                "00000000000000000000000000000000000000000000000000000000000000000000000000000000",
                "00000000000000000000000000000000000000000000000000000000000000000000000000000000",
                "00000000000000000000000000000000000000000000000000000000000000000000000000000000",
                "00000000000000000000000000000000000000000000000000000000000000000000000000000000",
                "00000000000000000000000000000000000000000000000000000000000000000000000000000000",
                "00000000000000000000000000000000000000000000000000000000000000000000000000000000",
                "00000000000000000000000000000000000000000000000000000000000000000000000000000000",
                "00000000000000000000000000000000000000000000000000000000000000000000000000000000",
                "00000000000000000000000000000000000000000000000000000000000000000000000000000000",
                "00000000000000000000000000000000000000000000000000000000000000000000000000000000",
                "00000000000000000000000000000000000000000000000000000000000000000000000000000000",
                "00000000000000000000000000000000000000000000000000000000000000000000000000000000",
                "00000000000000000000000000000000000000000000000000000000000000000000000000000000",
                "00000000000000000000000000000000000000000000000000000000000000000000000000000000",
                "00000000000000000000000000000000000000000000000000000000000000000000000000000000",
                "00000000000000000000000000000000000000000000000000000000000000000000000000000000",
                "00000000000000000000000000000000000000000000000000000000000000000000000000000000",
                "00000000000000000000000000000000000000000000000000000000000000000000000000000000",
                "00000000000000000000000000000000000000000000000000000000000000000000000000000000",
                "00000000000000000000000000000000000000000000000000000000000000000000000000000000",
                "00000000000000000000000000000000000000000000000000000000000000000000000000000000",
                "00000000000000000000000000000000000000000000000000000000000000000000000000000000",
                "00000000000000000000000000000000000000000000000000000000000000000000000000000000",
                "00000000000000000000000000000000000000000000000000000000000000000000000000000000",
                "00000000000000000000000000000000000000000000000000000000000000000000000000000000",
                "00000000000000000000000000000000000000000000000000000000000000000000000000000000",
                "00000000000000000000000000000000000000000000000000000000000000000000000000000000",
                "00000000000000000000000000000000000000000000000000000000000000000000000000000000",
                "00000000000000000000000000000000000000000000000000000000000000000000000000000000",
                "00000000000000000000000000000000000000000000000000000000000000000000000000000000",
                "00000000000000000000000000000000000000000000000000000000000000000000000000000000",
                "00000000000000000000000000000000000000000000000000000000000000000000000000000000",
                "00000000000000000000000000000000000000000000000000000000000000000000000000000000",
                "00000000000000000000000000000000000000000000000000000000000000000000000000000000",
                "00000000000000000000000000000000000000000000000000000000000000000000000000000000",
                "00000000000000000000000000000000000000000000000000000000000000000000000000000000",
                "00000000000000000000000000000011111111111100000000000000000000000000000000000000",
                "00000000000000000000000000000001010010001000000000000000000000000000000000000000",
                "00000000000000000000000000000001011111101000000000000000000000000000000000000000",
                "00000000000000000000000000000001010000101000000000000000000000000000000000000000",
                "00000000000000000000000000000001011111101000000000000000000000000000000000000000",
                "00000000000000000000000000000000000000000000000000000000000000000000000000000000",
                "00000000000000000000000000000000000000000000000000000000000000000000000000000000",
                "00000000000000000000000000000000000000000000000000000000000000000000000000000000",
                "00000000000000000000000000000000000000000000000000000000000000000000000000000000",
                "00000000000000000000000000000000000000000000000000000000000000000000000000000000",
                "00000000000000000000000000000000000000000000000000000000000000000000000000000000",
                "00000000000000000000000000000000000000000000000000000000000000000000000000000000",
                "00000000000000000000000000000000000000000000000000000000000000000000000000000000",
                "00000000000000000000000000000000000000000000000000000000000000000000000000000000",
                "00000000000000000000000000000000000000000000000000000000000000000000000000000000",
                "00000000000000000000000000000000000000000000000000000000000000000000000000000000",
                "00000000000000000000000000000000000000000000000000000000000000000000000000000000",
                "00000000000000000000000000000000000000000000000000000000000000000000000000000000",
                "00000000000000000000000000000000000000000000000000000000000000000000000000000000",
                "00000000000000000000000000000000000000000000000000000000000000000000000000000000",
                "00000000000000000000000000000000000000000000000000000000000000000000000000000000",
                "00000000000000000000000000000000000000000000000000000000000000000000000000000000",
                "00000000000000000000000000000000000000000000000000000000000000000000000000000000",
                "00000000000000000000000000000000000000000000000000000000000000000000000000000000",
                "00000000000000000000000000000000000000000000000000000000000000000000000000000000",
                "00000000000000000000000000000000000000000000000000000000000000000000000000000000",
                "00000000000000000000000000000000000000000000000000000000000000000000000000000000",
                "00000000000000000000000000000000000000000000000000000000000000000000000000000000",
                "00000000000000000000000000000000000000000000000000000000000000000000000000000000",
                "00000000000000000000000000000000000000000000000000000000000000000000000000000000",
                "00000000000000000000000000000000000000000000000000000000000000000000000000000000",
                "00000000000000000000000000000000000000000000000000000000000000000000000000000000",
                "00000000000000000000000000000000000000000000000000000000000000000000000000000000",
                "00000000000000000000000000000000000000000000000000000000000000000000000000000000",
                "00000000000000000000000000000000000000000000000000000000000000000000000000000000",
                "00000000000000000000000000000000000000000000000000000000000000000000000000000000",
                "00000000000000000000000000000000000000000000000000000000000000000000000000000000",
                "00000000000000000000000000000000000000000000000000000000000000000000000000000000",
                "00000000000000000000000000000000000000000000000000000000000000000000000000000000",
                "00000000000000000000000000000000000000000000000000000000000000000000000000000000"
            ],
            "terrains": [
                "................................................................................",
                "................................................................................",
                "..