{
    "levels": [
        {
            "visibleBox": {
                "height": 0.48,
                "cutLeft": 0.31,
                "cutRight": 0.29
            },
            "map": [
                "00000000000000000000000000000000000000000000000000000000000000000000000000000000",
                "00000000000000000000000000000000000000000000000000000000000000000000000000000000",
                "00000000000000000000000000000000000000000000000000000000000000000000000000000000",
                "00000000000000000000000000000000000000000000000000000000000000000000000000000000",
                "00000000000000000000000000000000000000000000000000000000000000000000000000000000",
                "00000000000000000000000000000000000000000000000000000000000000000000000000000000",
                "00000000000000000000000000000000000000000000000000000000000000000000000000000000",
                "00000000000000000000000000000000000000000000000000000000000000000000000000000000",
                "00000000000000000000000000000000000000000000000000000000000000000000000000000000",
                "00000000000000000000000000000000000000000000000000000000000000000000000000000000",
                "00000000000000000000000000000000000000000000000000000000000000000000000000000000",
                "00000000000000000000000000000000000000000000000000000000000000000000000000000000",
                "00000000000000000000000000000000000000000000000000000000000000000000000000000000",
                "00000000000000000000000000000000000000000000000000000000000000000000000000000000",
                "00000000000000000000000000000000000000000000000000000000000000000000000000000000",
                "00000000000000000000000000000000000000000000000000000000000000000000000000000000",
                "00000000000000000000000000000000000000000000000000000000000000000000000000000000",
                "00000000000000000000000000000000000000000000000000000000000000000000000000000000",
                "00000000000000000000000000000000000000000000000000000000000000000000000000000000",
                "00000000000000000000000000000000000000000000000000000000000000000000000000000000",
                "00000000000000000000000000000000000000000000000000000000000000000000000000000000",
                "00000000000000000000000000000000000000000000000000000000000000000000000000000000",
                "00000000000000000000000000000000000000000000000000000000000000000000000000000000",
                "00000000000000000000000000000000000000000000000000000000000000000000000000000000",
                "00000000000000000000000000000000000000000000000000000000000000000000000000000000",
                "00000000000000000000000000000000000000000000000000000000000000000000000000000000",
                "00000000000000000000000000000000000000000000000000000000000000000000000000000000",
                "00000000000000000000000000000000000000000000000000000000000000000000000000000000",
                "00000000000000000000000000000000000000000000000000000000000000000000000000000000",
                "00000000000000000000000000000000000000000000000000000000000000000000000000000000",
                "00000000000000000000000000000000000000000000000000000000000000000000000000000000",
                "00000000000000000000000000000000000000000000000000000000000000000000000000000000",
                "00000000000000000000000000000000000000000000000000000000000000000000000000000000",
                "00000000000000000000000000000000000000000000000000000000000000000000000000000000",
                "00000000000000000000000000000000000000000000000000000000000000000000000000000000",
                "00000000000000000000000000000000000000000000000000000000000000000000000000000000",
                "00000000000000000000000000000000000000000000000000000000000000000000000000000000",
                "00000000000000000000000000000000000000000000000000000000000000000000000000000000",
                "00000000000000000000000000000000000000000000000000000000000000000000000000000000",
                "00000000000000000000000000000000000000000000000000000000000000000000000000000000",
                "00000000000000000000000000000000000000000000000000000000000000000000000000000000",
                "00000000000000000000000000000000000000000000000000000000000000000000000000000000",
                "00000000000000000000000000000000000000000000000000000000000000000000000000000000",
                "00000000000000000000000000000000000000000000000000000000000000000000000000000000",
                "00000000000000000000000000000000000000000000000000000000000000000000000000000000",
                "00000000000000000000000000000000000000000000000000000000000000000000000000000000",
                "00000000000000000000000000000000000000000000000000000000000000000000000000000000",
                "00000000000000000000000000000000000000000000000000000000000000000000000000000000",
                "00000000000000000000000000000000000000000000000000000000000000000000000000000000",
                "00000000000000000000000000000000000000000000000000000000000000000000000000000000",
                "00000000000000000000000000000000000000000000000000000000000000000000000000000000",
                "00000000000000000000000000000000000000000000000000000000000000000000000000000000",
                "00000000000000000000000000000000000000000000000000000000000000000000000000000000",
                "00000000000000000000000000000000000000000000000000000000000000000000000000000000",
                "00000000000000000000000000000000000000000000000000000000000000000000000000000000",
                "00000000000000000000000000000000000000000000000000000000000000000000000000000000",
                "00000000000000000000000000000000000000000000000000000000000000000000000000000000",
                "00000000000000000000000000000000000000000000000000000000000000000000000000000000",
                "00000000000000000000000000000000000000000000000000000000000000000000000000000000",
                "00000000000000000000000000000000000000000000000000000000000000000000000000000000",
                "00000000000000000000000000000000000000000000000000000000000000000000000000000000",
                "00000000000000000000000000000000000000000000000000000000000000000000000000000000",
                "00000000000000000000000000000000000000000000000000000000000000000000000000000000",
                "00000000000000000000000000000000000000000000000000000000000000000000000000000000",
                "00000000000000000000000000000000000000000000000000000000000000000000000000000000",
                "00000000000000000000000000000000000000000000000000000000000000000000000000000000",
                "00000000000000000000000000000000000000000000000000000000000000000000000000000000",
                "00000000000000000000000000000000000000000000000000000000000000000000000000000000",
                "00000000000000000000000000000000000000000000000000000000000000000000000000000000",
                "00000000000000000000000000000000000000000000000000000000000000000000000000000000",
                "00000000000000000000000000000000000000000000000000000000000000000000000000000000",
                "00000000000000000000000000000000000000000000000000000000000000000000000000000000",
                "00000000000000000000000000000000000000000000000000000000000000000000000000000000",
                "00000000000000000000000000000000000000000000000000000000000000000000000000000000",
                "00000000000000000000000000000000000000000000000000000000000000000000000000000000",
                "00000000000000000000000000000000000000000000000000000000000000000000000000000000",
                "00000000000000000000000000000000000000000000000000000000000000000000000000000000",
                "00000000000000000000000000000000000000000000000000000000000000000000000000000000",
                "00000000000000000000000000000000000000000000000000000000000000000000000000000000",
                "00000000000000000000000000000000000000000000000000000000000000000000000000000000"
            ],
            "terrains": [
                "................................................................................",
                "................................................................................",
                "................................................................................",
                "................................................................................",
                "................................................................................",
                "................................................................................",
                "................................................................................",
                "................................................................................",
                "................................................................................",
                "................................................................................",
                "................................................................................",
                "................................................................................",
                "................................................................................",
                "................................................................................",
                "................................................................................",
                "................................................................................",
                "................................................................................",
                "................................................................................",
                "................................................................................",
                "................................................................................",
                ".................................................ss.............................",
                "......................................sss......sssss............................",
                ".................................sss..sss....sssssss............................",
                ".................................sssssss.....s..sss.............................",
                "................................sssssss......s...ss.............................",
                "................................sssssss......ss..s..............................",
                ".................................ssssss.......ssss..............................",
                "...........................ss....ssssss.........................................",
                "..........................sss.ssss..sss.........................................",
                ".........................sss..ssss..sss........ss...............................",
                ".........................sss..sssssssss.......ssss..............................",
                ".........................s....ssssssss......ssssss..............................",
                "...........................sssssssss........sssssss.............................",
                "........................ss.sssssssss.......sssssssss............................",
                "........................ssssssssssss.......ssssssssss...........................",
                "......................sssssssssssss........sss..sssss...........................",
                "......................sssssssssssss........sss..ssss............................",
                ".....................ssssssssssssss......sssssssss..............................",
                ".....................s..ssssssssssss....ssssssssss.......ss.....................",
                "....................ss..ssssssssssss...sssssssssssss.....sss....................",
                "....................ssssssss...ssss....sssssssssssss.....sss....................",
                "....................ssssssss...ssss....ssssssssssssss.....ss....................",
                "....................sssssssss.sssss....sssssssssssssss..........................",
                "....................sssssssssssssss....sssssssssssssss..........................",
                "....................sssssssssssssss....ssssssssssssss...........................",
                "....................sssssssssssssss.....ss...ssssssss...........................",
                ".....................sssss...ss..............sssssss............................",
                ".....................ssssss.....ss.........ssssssss...ss........................",
                "......................sssss..sssss........sssssssss..sss........................",
                ".......................ss...sssssss.......sssssssssssssss.......................",
                "..........................sssssssss.......sssssssssssssss.......................",
                "......................ssssssssssss.........sssssssssssss........................",
                ".......................sssssssssss...........ssss..ssss.........................",
                ".......................ssssssssss.....sss....ssss..ssss.........................",
                "........................sssssssss.....ssss.....ss...ss..........................",
                "..........................sssss........sss......................................",
                "............................ss...............sss................................",
                "............................................sssss...............................",
                "............................................sssss...............................",
                ".............................................sss................................",
                "................................................................................",
                "................................................................................",
                "................................................................................",
                "................................................................................",
                "................................................................................",
                "................................................................................",
                "................................................................................",
                "................................................................................",
                "................................................................................",
                "................................................................................",
                "................................................................................",
                "................................................................................",
                "................................................................................",
                "................................................................................",
                "................................................................................",
                "................................................................................",
                "................................................................................",
                "................................................................................",
                "................................................................................",
                "................................................................................"
            ],
            "field": [],
            "episodeNo": "editor",
            "levelNo": 0,
            "version": 0
        }
    ]
}